NO textures/moire.xpm
EA textures/moire.xpm
SO textures/moire.xpm
WE textures/moire.xpm

C 0,0,0
F 255,255,255

111111111111111
10E000000011111
100000010011111
100011111101111
100100000000011
110000000000011
100001111100001
110000111000011
111000010000111
111100000001111
111110000011111
100011000000011
111111111111111
