F 139,99,58
C 171,154,137

NO textures/simonkraft/bookshelf.xpm
SO textures/simonkraft/bookshelf_01.xpm
WE textures/simonkraft/bookshelf_02.xpm
EA textures/simonkraft/bookshelf_03.xpm

        11111111111111111111111111
        1N0001001001001001001001
11111111010010010011111111111111
10010010010010010000000001
10010010000010010011000001
10000000000000000011111111
1000011111111000001
1111000000000001111
1000000101010000001
1111111111111111111

